# lvlwidth 28
# lvlheight 36
# bgcolor 0 0 0
# edgelightcolor 0 0 255
# edgeshadowcolor 35 41 95
# fillcolor 0 0 0
# pelletcolor 238 183 128
# fruittype 3

# startleveldata
' 1 002 003 004 005 006 007 008 009 010 011 012 013 014 015 016 017 018 019 020 021 022 023 024 025 026 027 028
000 000 000 000 000 000 000 000 000 000 000 000 000 000 000 000 000 000 000 000 000 000 000 000 000 000 000 000
000 000 000 000 000 000 000 000 000 000 000 000 000 000 000 000 000 000 000 000 000 000 000 000 000 000 000 000
000 000 000 000 000 000 000 000 000 000 000 000 000 000 000 000 000 000 000 000 000 000 000 000 000 000 000 000
112 100 100 100 100 100 100 100 100 100 100 100 100 115 114 100 100 100 100 100 100 100 100 100 100 100 100 113
102 002 002 002 002 002 002 002 002 002 002 002 002 105 104 002 002 002 002 002 002 002 002 002 002 002 002 103
102 002 117 107 107 116 002 117 107 107 107 116 002 105 104 002 117 107 107 107 116 002 117 107 107 116 002 103
102 003 105 000 000 104 002 105 000 000 000 104 002 105 104 002 105 000 000 000 104 002 105 000 000 104 003 103
102 002 119 106 106 118 002 119 106 106 106 118 002 119 118 002 119 106 106 106 118 002 119 106 106 118 002 103
102 002 002 002 002 002 002 002 002 002 002 002 002 002 002 002 002 002 002 002 002 002 002 002 002 002 002 103
102 002 117 107 107 116 002 117 116 002 117 107 107 107 107 107 107 116 002 117 116 002 117 107 107 116 002 103
102 002 119 106 106 118 002 105 104 002 119 106 106 123 122 106 106 118 002 105 104 002 119 106 106 118 002 103
102 002 002 002 002 002 002 105 104 002 002 002 002 105 104 002 002 002 002 105 104 002 002 002 002 002 002 103
110 101 101 101 101 116 002 105 120 107 107 116 000 105 104 000 117 107 107 121 104 002 117 101 101 101 101 111
000 000 000 000 000 102 002 105 122 106 106 118 000 119 118 000 119 106 106 123 104 002 103 000 000 000 000 000
000 000 000 000 000 102 002 105 104 000 000 000 000 000 000 000 000 000 000 105 104 002 103 000 000 000 000 000
000 000 000 000 000 102 002 105 104 000 125 101 101 000 000 101 101 124 000 105 104 002 103 000 000 000 000 000
100 100 100 100 100 118 002 119 118 000 103 000 000 000 000 000 000 102 000 119 118 002 119 100 100 100 100 100
000 000 000 000 000 000 002 000 000 000 103 000 000 000 000 000 000 102 000 000 000 002 000 000 000 000 000 000
101 101 101 101 101 116 002 117 116 000 103 000 000 000 000 000 000 102 000 117 116 002 117 101 101 101 101 101
000 000 000 000 000 102 002 105 104 000 127 100 100 100 100 100 100 126 000 105 104 002 103 000 000 000 000 000
000 000 000 000 000 102 002 105 104 000 000 000 000 000 000 000 000 000 000 105 104 002 103 000 000 000 000 000
000 000 000 000 000 102 002 105 104 000 117 107 107 107 107 107 107 116 000 105 104 002 103 000 000 000 000 000
112 100 100 100 100 118 002 119 118 000 119 106 106 123 122 106 106 118 000 119 118 002 119 100 100 100 100 113
102 002 002 002 002 002 002 002 002 002 002 002 002 105 104 002 002 002 002 002 002 002 002 002 002 002 002 103
102 002 117 107 107 116 002 117 107 107 107 116 002 105 104 002 117 107 107 107 116 002 117 107 107 116 002 103
102 002 119 106 123 104 002 119 106 106 106 118 002 119 118 002 119 106 106 106 118 002 105 122 106 118 002 103
102 003 002 002 105 104 002 002 002 002 002 002 002 004 004 002 002 002 002 002 002 002 105 104 002 002 003 103
128 107 116 002 105 104 002 117 116 002 117 107 107 107 107 107 107 116 002 117 116 002 105 104 002 117 107 129
130 106 118 002 119 118 002 105 104 002 119 106 106 123 122 106 106 118 002 105 104 002 119 118 002 119 106 131
102 002 002 002 002 002 002 105 104 002 002 002 002 105 104 002 002 002 002 105 104 002 002 002 002 002 002 103
102 002 117 107 107 107 107 121 120 107 107 116 002 105 104 002 117 107 107 121 120 107 107 107 107 116 002 103
102 002 119 106 106 106 106 106 106 106 106 118 002 119 118 002 119 106 106 106 106 106 106 106 106 118 002 103
102 002 002 002 002 002 002 002 002 002 002 002 002 002 002 002 002 002 002 002 002 002 002 002 002 002 002 103
110 101 101 101 101 101 101 101 101 101 101 101 101 101 101 101 101 101 101 101 101 101 101 101 101 101 101 111
0 0 0 0 0 0 0 0 0 0 0 0 0 0 0 0 0 0 0 0 0 0 0 0 0 0 0 0
0 0 0 0 0 0 0 0 0 0 0 0 0 0 0 0 0 0 0 0 0 0 0 0 0 0 0 0
# endleveldata

# startcollisiondata
'  02 03 04 05 06 07 08 09 10 11 12 13 14 15 16 17 18 19 20 21 22 23 24 25 26 27 28
00 00 00 00 00 00 00 00 00 00 00 00 00 00 00 00 00 00 00 00 00 00 00 00 00 00 00 00
00 00 00 00 00 00 00 00 00 00 00 00 00 00 00 00 00 00 00 00 00 00 00 00 00 00 00 00
00 00 00 00 00 00 00 00 00 00 00 00 00 00 00 00 00 00 00 00 00 00 00 00 00 00 00 00
00 00 00 00 00 00 00 00 00 00 00 00 00 00 00 00 00 00 00 00 00 00 00 00 00 00 00 00
00 01 01 01 01 01 01 01 01 01 01 01 01 00 00 01 01 01 01 01 01 01 01 01 01 01 01 00
00 01 00 00 00 00 01 00 00 00 00 00 01 00 00 01 00 00 00 00 00 01 00 00 00 00 01 00
00 01 00 00 00 00 01 00 00 00 00 00 01 00 00 01 00 00 00 00 00 01 00 00 00 00 01 00
00 01 00 00 00 00 01 00 00 00 00 00 01 00 00 01 00 00 00 00 00 01 00 00 00 00 01 00
00 01 01 01 01 01 01 01 01 01 01 01 01 01 01 01 01 01 01 01 01 01 01 01 01 01 01 00
00 01 00 00 00 00 01 00 00 01 00 00 00 00 00 00 00 00 01 00 00 01 00 00 00 00 01 00
00 01 00 00 00 00 01 00 00 01 00 00 00 00 00 00 00 00 01 00 00 01 00 00 00 00 01 00
00 01 01 01 01 01 01 00 00 01 01 01 01 00 00 01 01 01 01 00 00 01 01 01 01 01 01 00
00 00 00 00 00 00 01 00 00 00 00 00 01 00 00 01 00 00 00 00 00 01 00 00 00 00 00 00
00 00 00 00 00 00 01 00 00 00 00 00 01 00 00 01 00 00 00 00 00 01 00 00 00 00 00 00
00 00 00 00 00 00 01 00 00 01 01 01 01 01 01 01 01 01 01 00 00 01 00 00 00 00 00 00
00 00 00 00 00 00 01 00 00 01 00 00 00 01 01 00 00 00 01 00 00 01 00 00 00 00 00 00
00 00 00 00 00 00 01 00 00 01 00 01 01 01 01 01 01 00 01 00 00 01 00 00 00 00 00 00
03 03 03 03 03 03 01 01 01 01 00 01 01 01 01 01 01 00 01 01 01 01 03 03 03 03 03 03
00 00 00 00 00 00 01 00 00 01 00 01 01 01 01 01 01 00 01 00 00 01 00 00 00 00 00 00
00 00 00 00 00 00 01 00 00 01 00 00 00 00 00 00 00 00 01 00 00 01 00 00 00 00 00 00
00 00 00 00 00 00 01 00 00 01 01 01 01 01 01 01 01 01 01 00 00 01 00 00 00 00 00 00
00 00 00 00 00 00 01 00 00 01 00 00 00 00 00 00 00 00 01 00 00 01 00 00 00 00 00 00
00 00 00 00 00 00 01 00 00 01 00 00 00 00 00 00 00 00 01 00 00 01 00 00 00 00 00 00
00 01 01 01 01 01 01 01 01 01 01 01 01 00 00 01 01 01 01 01 01 01 01 01 01 01 01 00
00 01 00 00 00 00 01 00 00 00 00 00 01 00 00 01 00 00 00 00 00 01 00 00 00 00 01 00
00 01 00 00 00 00 01 00 00 00 00 00 01 00 00 01 00 00 00 00 00 01 00 00 00 00 01 00
00 01 01 01 00 00 01 01 01 01 01 01 01 01 01 01 01 01 01 01 01 01 00 00 01 01 01 00
00 00 00 01 00 00 01 00 00 01 00 00 00 00 00 00 00 00 01 00 00 01 00 00 01 00 00 00
00 00 00 01 00 00 01 00 00 01 00 00 00 00 00 00 00 00 01 00 00 01 00 00 01 00 00 00
00 01 01 01 01 01 01 00 00 01 01 01 01 00 00 01 01 01 01 00 00 01 01 01 01 01 01 00
00 01 00 00 00 00 00 00 00 00 00 00 01 00 00 01 00 00 00 00 00 00 00 00 00 00 01 00
00 01 00 00 00 00 00 00 00 00 00 00 01 00 00 01 00 00 00 00 00 00 00 00 00 00 01 00
00 01 01 01 01 01 01 01 01 01 01 01 01 01 01 01 01 01 01 01 01 01 01 01 01 01 01 00
00 00 00 00 00 00 00 00 00 00 00 00 00 00 00 00 00 00 00 00 00 00 00 00 00 00 00 00
00 00 00 00 00 00 00 00 00 00 00 00 00 00 00 00 00 00 00 00 00 00 00 00 00 00 00 00
00 00 00 00 00 00 00 00 00 00 00 00 00 00 00 00 00 00 00 00 00 00 00 00 00 00 00 00
# endcollisiondata

# sprites
